h-......................................
.-..----------------------------------..
.-.--................................--.
.-.-...----------------------------.---.
.-.---....-.........................-.-.
.-.-......-------------------------.-.-.
.-.-.------------------------.......-.-.
.-.-......-...................-------.-.
.-.------.-.-------------------.......-.
.-.-......-.-............-----...---..-.
.-.-..-----.-.....---.....----....--.--.
.-.-......-.-....-----......----..-...-.
.-.-----..-.-....-...-......--....---.-.
.-........-.-.----.-.------.--..----..-.
.----------.-.-....-......-.---...-...-.
.-...-......-.-.---------.-.---.---.---.
.-.-.-.------.-.-.......-.-.--....-..--.
.-.-.-.--...-.-.-.-----.-.-..---.--...-.
.-.-.-.--.-.-.-.-.-...-.-.--..--..---.-.
.-.-.-.--.-.-.-.-.-g-.-.-..--..--.-...-.
.-.-.-.--.-.-.-.-.---.-.--..--..-.-.---.
.-.-.-.--.-.-.-.-.....-.---..--.-.-...-.
.-.-.-.--.-.-.-.-------.-.--..-.-.---.-.
.-.-.-.--.-.-.-.........-.....-.-.-...-.
.-.-.-.--.-.-.-----------.....-.-.-.---.
.-.-.-.--.-.-.................-.-.-...-.
.-.-.-.--.-.-------------------.-.-.-.-.
.-.-.-.--.-.....................-.-.-.-.
.-.-.-.--.-----------------------.---.-.
.-.-.-.--.........................-...-.
.-.-.-.----------------------------.---.
.-.-.-..--...-.....----....--...-.....-.
.-.-.--....-.-..--..--..--..-.-.-----.-.
.-.-..--...-...----....----...-.......-.
.-.--..--------------------------------.
.-..--..................................
.--..-----------------------------------
..--....................................
...----------------------------------...
........................................