h-......................................
.-..----------------------------------..
.-.--................................--.
.-.-...----------------------------.---.
.-.---....-.........................-.-.
.-.-......-.-----------------------.-.-.
.-.-.------.---------------------...-.-.
.-.-......-.....................-----.-.
.-.------.-.-------------------.......-.
.-.-......---------------------..---..-.
.-.-..-----...................-...--.--.
.-.-......-.-----------------.--......-.
.-.-----..-.-...............-.-...---.-.
.-........-.-.-------------.-.-.----..-.
.----------.-.-...........-.-.-...-...-.
.-...-....-.-.-.---------.-.-.-.---.---.
.-.-.-.--.-.-.-.-.......-.-.-.-...-..--.
.-.-.-.--.-.-.-.-.-----.-.-.-.--.--...-.
.-.-.-.--.-.-.-.-.-...-.-.-.-.--..---.-.
.-.-.-.--.-.-.-.-.-g-.-.-.-.-.---.-...-.
.-.-.-.--.-.-.-.-.---.-.-.-.-.-.-.-.---.
.-.-.-.--.-.-.-.-.....-.-.-.-.-.-.-...-.
.-.-.-.--.-.-.-.-------.-.-.-.-.-.---.-.
.-.-.-.--.-.-.-.........-.-.-.-.-.-...-.
.-.-.-.--.-.-.-----------.-.-.-.-.-.---.
.-.-.-.--.-.-.............-.-.-.-.-...-.
.-.-.-.--.-.---------------.-.-.-.-.-.-.
.-.-.-.--.-.................-.-.-.-.-.-.
.-.-.-.--.-------------------.---.---.-.
.-.-.-.--.....................-...-...-.
.-.-.-.----------------------------.---.
.-.-.-..--...-.....----....--...-.....-.
.-.-.--....-.-..--..--..--..-.-.-----.-.
.-.-..--...-...----....----...-.......-.
.-.--..--------------------------------.
.-..--..................................
.--..-----------------------------------
..--....................................
...----------------------------------...
........................................